1111111111111111111111111111111111
1C0000000000000000000000000E000001
1111011111111111111111111111111111
1100000000C0C0C000C00C000000000011
1P0000000000000000000000000C10C001
1111111111111111111111111111111111